0,,,0,0,0,0,0,0,0,0,0,0,0,0,0,0,0,0,0,2-,0,0,0,0,0,0,0,0,0,30,0,0,0,0,0,0,0,0,0,40,0,0,0,0,0
0,,,,,,,,,,,0,0,0,0,2,2,2,,3,3,3,3,3,3,3,3,3,3,3,3,0,0,0,0,0,0,0,0,0,0,0,0,0,0,0
0,,,1,1,,,,,,,0,0,2,2,2,2,2,0,3,3,3,3,3,3,3,3,3,3,3,3,3,3,3,0,0,0,0,0,0,0,0,0,0,0,0
0,,,1,1,1,1,,,,0,0,2,2,2,2,2,2,2,2,2,2,2,3,3,3,3,3,3,3,3,3,3,3,3,3,0,0,0,0,0,0,0,0,0,0
0,,,1,1,0,1,,,,1,1,1,0,0,1,1,1,2,1,2,2,2,3,3,3,3,3,3,3,3,3,3,3,3,3,3,0,0,0,0,0,0,0,0,0
0,,,1,1,0,0,1,1,1,1,1,1,1,1,1,1,,1,,2,2,2,3,3,3,3,3,3,3,3,3,3,3,3,3,3,3,0,0,0,0,0,0,0,0
0,,,0,0,0,0,0,1,1,1,1,1,1,1,1,1,,0,,2,2,2,2,3,3,3,3,3,3,3,3,3,3,3,3,3,3,3,,3,0,0,0,0,0
0,,,0,0,0,0,0,,1,1,1,1,1,1,1,0,1,0,0,2,2,2,2,2,2,2,2,2,3,3,3,3,3,3,3,3,3,3,3,3,0,0,0,0,0
0,,,0,0,0,0,0,0,1,1,1,1,1,1,1,1,4,1,0,2,2,2,2,2,2,2,2,2,2,3,3,3,3,3,3,3,3,3,3,,0,0,0,0,0
0,,,0,0,0,0,,,1,1,1,1,1,1,1,4,4,1,1,0,0,2,2,2,2,2,2,2,2,2,3,3,3,3,3,3,3,3,3,3,,0,0,0,0
0,,,0,0,7,0,1,1,1,1,1,1,1,1,1,1,4,4,4,1,,2,2,2,2,2,2,2,2,2,2,3,3,3,3,3,3,3,3,3,,,0,0,0
0,,,0,7,7,1,1,1,1,1,1,1,1,1,1,1,4,4,4,4,1,2,2,2,2,2,2,2,2,2,2,3,3,3,3,3,3,3,3,3,,,0,0,0
0,,,0,7,7,7,0,1,1,1,1,1,1,1,1,1,1,4,4,4,4,1,2,2,2,2,2,2,2,2,2,3,3,3,3,3,3,3,3,2,,,0,0,0
0,,0,7,7,7,,0,0,0,,1,1,1,1,1,1,1,1,4,4,4,4,1,2,2,2,2,2,2,2,2,2,3,3,3,3,3,3,3,2,2,,0,0,0
0,,7,7,7,0,0,0,0,7,1,1,1,1,1,1,1,1,1,4,4,4,0,1,1,2,2,2,2,2,2,2,2,2,3,3,3,3,3,2,2,2,,0,0,0
0,7,7,7,7,7,7,7,7,7,1,1,1,1,1,1,1,1,1,4,1,4,4,4,1,2,2,2,2,2,2,2,2,2,2,3,3,3,3,2,2,2,,0,0,0
0,7,7,7,7,7,7,7,7,7,7,1,1,1,1,1,1,1,4,1,1,4,4,4,1,1,2,2,2,2,2,2,2,2,2,2,2,2,2,2,2,2,,0,0,0
0,7,7,7,7,7,7,7,7,7,7,0,1,1,1,1,1,4,4,4,4,4,4,4,4,1,2,2,2,2,2,2,2,2,2,2,2,2,2,2,2,,,0,0,0
0,7,7,7,7,7,7,7,7,7,7,0,7,1,1,1,1,4,4,4,4,4,4,4,4,1,2,2,2,2,2,2,2,2,2,2,2,2,2,2,2,,,0,0,0
0,7,7,7,7,7,7,7,7,7,7,7,7,7,1,1,1,1,4,4,4,4,4,4,4,4,1,2,2,2,2,2,2,2,2,2,2,2,2,,,,,0,0,0
0,,7,7,7,7,7,7,7,7,7,7,7,7,1,1,1,1,4,4,4,4,4,4,4,4,4,1,,2,2,2,2,2,2,2,2,2,2,,,,,0,0,0
0,,7,7,7,7,7,7,7,7,7,7,7,7,1,1,1,1,1,4,4,4,4,4,4,4,4,4,1,2,2,2,2,2,2,2,2,2,2,,,,2,0,0,0
0,,7,7,7,7,7,7,7,7,7,7,7,7,7,1,1,1,1,1,4,4,4,4,4,4,4,4,4,1,1,1,1,1,2,2,2,2,2,,,2,2,2,0,0
0,,7,7,7,7,7,6,7,7,7,7,7,7,7,7,1,1,1,1,1,1,4,4,4,4,4,4,4,4,4,4,1,1,2,2,2,2,2,,2,2,2,2,0,0
0,,6,,0,6,6,6,7,7,7,7,7,7,7,7,1,1,1,1,1,1,4,4,4,4,4,4,4,4,4,4,4,1,1,2,2,2,2,2,2,2,,0,0,0
0,,6,6,6,6,,,7,7,7,7,7,7,7,7,1,1,1,1,1,,,4,4,4,4,4,4,4,4,4,4,1,1,1,2,2,2,2,2,2,2,0,0,0
0,,6,6,6,6,6,6,7,7,7,7,7,7,7,7,7,1,1,1,,,,4,4,4,4,4,4,4,4,4,4,1,1,0,,2,2,2,2,2,0,0,0,0
0,,6,6,6,6,6,6,6,7,7,7,7,7,7,7,7,6,6,,,,4,4,4,4,4,4,4,4,4,4,4,4,4,4,4,4,2,2,2,0,,0,0,0
0,,,6,6,6,6,6,6,7,7,7,7,7,7,7,6,6,,,,0,4,4,4,4,4,4,4,4,4,4,4,4,4,4,4,4,,2,2,0,0,0,0,0
0,,,6,6,6,6,6,6,6,6,7,7,7,6,6,6,6,,0,4,4,4,4,4,4,4,4,4,4,4,4,4,4,4,4,4,4,4,4,4,4,4,0,0,0
0,,,6,6,6,6,6,6,6,6,6,6,6,6,6,6,6,4,4,4,4,4,4,4,4,4,4,4,4,4,4,4,4,4,4,4,4,4,4,4,4,4,0,0,0
0,,,0,6,6,6,6,6,6,6,6,6,6,6,6,6,6,5,4,4,4,4,4,4,4,4,4,4,4,4,4,4,4,4,4,4,4,4,4,4,4,4,0,0,0
0,,,0,6,6,6,6,6,6,6,6,6,6,6,6,6,5,5,5,5,5,4,4,4,4,4,4,4,4,4,4,4,4,4,4,4,4,4,4,4,4,4,0,0,0
0,,,0,6,6,6,6,6,6,6,6,6,6,6,6,6,5,5,5,5,5,5,4,4,4,4,4,4,4,4,4,4,4,4,4,4,4,4,4,4,4,,0,0,0
0,,,0,0,6,6,6,6,6,6,6,6,6,6,6,6,5,5,5,5,5,5,4,4,4,4,4,4,4,4,4,4,4,4,4,4,4,4,4,4,4,,0,0,0
0,,,0,0,6,6,6,6,6,6,6,6,6,6,6,5,5,5,5,5,5,5,4,4,4,4,4,4,4,4,4,4,4,4,4,4,4,4,4,4,4,0,0,0,0
0,,,0,0,6,6,6,,0,6,6,6,6,6,6,5,5,5,5,5,5,5,5,4,4,4,4,4,4,4,4,4,4,4,4,4,4,4,4,4,0,0,0,0,0
0,,,0,0,0,6,6,6,,6,6,6,6,6,6,5,5,5,5,5,5,5,5,4,4,4,4,4,4,4,4,4,4,4,4,4,4,4,4,4,0,0,0,0,0
0,,,0,0,0,0,6,6,6,6,6,6,6,6,5,5,5,5,5,5,5,5,5,5,4,4,4,4,4,4,4,4,4,4,4,4,4,4,4,0,0,0,0,0,0
0,,,0,0,0,0,0,6,6,6,5,6,6,6,5,5,5,5,5,5,5,5,5,5,5,5,4,4,4,4,4,4,4,4,4,4,4,4,4,0,0,0,0,0,0
0,,,0,0,0,0,0,0,6,5,5,5,6,6,5,5,5,5,5,5,5,5,5,5,5,5,4,4,4,4,4,4,4,4,4,4,4,6,6,0,0,0,0,0,0
0,,,0,0,0,0,0,0,0,5,5,5,5,6,6,6,6,5,5,5,5,5,5,5,6,,4,4,4,4,4,4,4,4,6,6,6,6,0,0,0,0,0,0,0
0,,,0,0,0,0,0,0,0,0,5,5,5,5,6,6,6,,5,5,5,5,5,5,5,6,6,6,6,6,6,6,6,6,0,0,0,0,0,0,0,0,0,0,0
0,,,0,0,0,0,0,0,0,0,0,0,0,0,0,0,6,0,0,0,0,5,5,0,5,C81,0,0,0,0,0,0,0,0,0,0,0,0,0,0,0,0,0,0,0